PPPPPPPPPPPPPPPPPPPPPPPPPPPPPPPPPPPPPPPPP
W										W	
W	S									W
W										W
WPPPPPPPPPPPPPPPPPPPPPPPPP				W
W										W
W										W
W										W
W						PPPPPPPPPPPPPPPPW
W										W
W										W
W										W
WPPPPPPPPPPPPPPPPPPPPPPPPPPPPPPPPPPPPPPPW